{
  " ": " ",
  "#": "#",
  "'": "ⲯ",
  ",": "ⲭ",
  ".": ".",
  "/": "ⲏ",
  ":": ":",
  "<": "Ⲭ",
  "A": "Ⲁ",
  "C": "Ⲥ",
  "D": "Ⲇ",
  "E": "Ⲉ",
  "F": "Ϥ",
  "I": "Ⲓ",
  "J": "Ϫ",
  "K": "Ⲕ",
  "M": "Ⲙ",
  "N": "Ⲛ",
  "O": "Ⲟ",
  "P": "Ⲡ",
  "Q": "Ϧ",
  "S": "Ϣ",
  "T": "Ⲧ",
  "U": "Ⲩ",
  "V": "Ⲫ",
  "Y": "Ⲑ",
  "[": "ϭ",
  "]": "ϯ",
  "a": "ⲁ",
  "b": "ⲃ",
  "c": "ⲥ",
  "d": "ⲇ",
  "e": "ⲉ",
  "f": "ϥ",
  "g": "ⲅ",
  "h": "ϩ",
  "i": "ⲓ",
  "j": "ϫ",
  "k": "ⲕ",
  "l": "ⲗ",
  "m": "ⲙ",
  "n": "ⲛ",
  "o": "ⲟ",
  "p": "ⲡ",
  "q": "ϧ",
  "r": "ⲣ",
  "s": "ϣ",
  "t": "ⲧ",
  "u": "ⲩ",
  "v": "ⲫ",
  "w": "ⲱ",
  "x": "ⲝ",
  "y": "ⲑ",
  "z": "ⲍ",
  "}": "Ϯ",
  "~": "̀"
}